바베큐	NNG
서퍼	NNG
도미토리	NNG
쏠비치	NNP
설해원	NNP
차단기	NNG
빌트인	NNG
혼맥	NNG
두께감	NNG
신축성	NNG
낙산비치호텔	NNP
휴휴암	NNP
뷰	NNG
드라이기 NNG
파우치	NNG
아이스버킷	NNG
와인잔	NNG
해오름	NNG
황태국	NNG
쉐프스키친	NNP
오션플레이	NNP
대명리조트	NNP